.w...2w.wA.
....+w..ww.
.w2.ww...w.
.gw.w..w...
....w..w.w.
.ww.......w
...w1..2w.1
