....2....ww
..w2....www
w...w.A...3
..w.w.w..w1
.....w..ww.
.www...gw..
....w....w+
