.w...w.ww+.
.ww..w.w...
.......w..w
..www.w..w.
.g......w..
.w.ww.....2
.w..1..wA..
