w...w.....1
...2.......
w..w.w..w..
.w..w..w...
.www...Ag..
+.........w
.w........3
