.1.w...A...
.w.w...wg..
2...ww..w..
ww.w.1w..w.
+...w......
...........
...ww.3w.w.
