1.w.....w..
1.........w
..w.w...gw.
www......A.
ww..w...ww.
....w..ww..
+....w2w..w
