.A....w..w.
w....w..w..
.w....w..3.
.....ww.ww+
..w.3..2ww.
.wwg.w.w...
.www.......
