.ww.1..w...
...........
.w.w..3wg..
..1..www.w.
..www.w....
w.w.w..w...
+.A..1...w.
