.w.g.w1....
1....www...
.....w21.w2
w.1wAw..w.w
.w...w.w...
.........w+
w.....3.ww.
