w..w.ww..ww
...........
.ww.ww2....
..2w.g..ww.
.......w...
w.....w..+w
.A..w.1....
