w.....w.w..
.ww..+w....
.........1.
...w1.1w...
...1.w....g
3.....w..A.
....w.www..
