.ww.....g.w
..ww...ww..
.3w..ww1w.w
..+........
........w..
......w....
.ww.....wA.
