..w.w1wA..w
3ww.+.w....
....w..w..w
..w.ww.w..3
..w...1...w
w.......w..
w....w.g..w
