...........
.w..Aw...1g
.....ww.w..
.w.ww1.....
w...www....
+.......w..
wwww.w.2..w
