2..2..w..ww
.w....3..A.
.ww3..w....
w.g.w.w.ww.
....www3.ww
....w.w.+..
.......2...
