..ww...w..3
...w.......
.w.....w...
ww.www..1w.
..wg.w.w+2.
..w....w...
....wA.ww..
