.....1.w...
......wg...
....w..A..w
ww2..w.w..w
.w.w.....w.
..w.w..w.w.
w......+...
