.w...ww...w
.ww.ww...A.
.w.....www.
.1ww..g....
..w..w....w
..ww..ww.1.
13.......+.
