...w.......
..1.......3
.www.wwww..
...wwww....
...+....w..
..ww.w....w
.....wwAg.w
