www...1ww..
w..........
.ww......w1
.......3..w
.www..+....
g31.w......
....A.....w
