.w.........
2.w...Aw..w
.3..2......
2w..ww.w...
..w.+w.w3w.
..w..wg.w.1
..ww.......
