..ww......g
w..ww.....w
....w......
w...w..w.Aw
.w..w...www
.......w+..
.1...w...ww
