....www....
w...w..3+.w
1.....ww...
..w2..A....
.w.......w.
....w...w..
..w.gw.....
