.w.ww......
..3.w.w....
w.w......w.
......w....
..w3.wg+...
w.Aw.w.2...
..w...w....
