2w..www.ww.
..w......w.
w....A...2.
..ww......w
...........
...w.g.w..+
..1w....w..
