3.w........
.ww....A..w
3.w...w....
w.w....w...
....3w2....
w..g.......
....wwww+ww
