wwAw.gw..ww
.w....w.w..
.ww...w....
...w......w
..ww..w..w.
w.w.......+
....2......
