......w..w.
.+..www....
....w...2..
w...w.....g
A....2.w.w.
..2.w..w...
..ww..2..w.
