.w...w..w.w
.w...w.....
...........
w...w.+w...
..w.w.w..w.
w.wA.ww..3.
..w....gw..
