w....w.w..w
....gw.+Aw.
...w..w....
.......w.w.
..www.w...w
..w...2....
....w...w..
