.......1..A
......2w.g.
...ww...ww.
....w......
..wwwww.ww.
.+.w..w....
.w3..w....w
