......w....
ww3+.......
..w...www.w
w....w.wA..
.w...w.ww..
.3..w..wg..
w....1.....
