....2......
www..w....+
......ww.w.
.w..Aw.....
.....w..w3.
.wg....ww..
....ww1.1..
