.ww.2..w.ww
..ww.......
A.....ww..3
.....ww....
ww...ww..w+
.....w....w
.www...g...
