3ww........
..w..w.w.g2
w1w......w.
w..ww..www.
+...w.wA...
.w2.......w
..w........
