....w..w1w+
w....w.....
..w.Aw.w...
..ww.ww....
.......2w..
1.g3wwww...
ww1...w..w.
