..w...w...w
.w.........
.......1...
w.w.w....w.
..w....wwA.
.......w...
w.+w.....gw
