g.......w..
w..w.ww1.w.
........w2.
w...1.w...w
.1ww.....w.
...w.w+....
w..3ww.A...
