...w.1...wA
3....w.w...
.3w..www...
w3....ww...
.w...w..w.w
..3.w......
www...g...+
