....w+...w.
..1www.w...
w..w..w...A
g..w.3.....
.....w..w..
2w...w....w
w..w....w.w
