..w........
...w..w.w..
..ww.ww.3w.
w...2+w..w.
..w.ww2....
w.2..ww.w..
........gA.
