w........w1
w..........
.........Aw
www+..www.w
.w..ww...wg
3.....w....
.........w.
