.2...w..1.+
.wwg.1w....
..3.......1
w.w.A.ww...
.....w.www3
ww.w.......
.3.w.ww.ww.
