2w....ww.w1
...A.www...
...wwg...w.
+..w.2w...w
.w.....3w..
.....w1...w
.w.w..w...w
