..w...w..+.
w.1.w......
..2wg.w3..w
2w.wA......
.w..w.w..1.
.ww......3w
.ww.......w
