1...3....gw
...w3..3w+.
..ww..w....
w...w3.w...
Aw.ww...w..
.w.ww....w3
..2...w..ww
