....Awww..g
2....w.....
..ww...w.3w
.www.+...1.
....w.w1.w.
w..........
w.....w...w
