..g3.w....A
w.....w.w..
....w.ww.w.
w.2......w.
....w...+.3
..w.w..w..w
....1....3.
