w...ww.2...
....1..gw.A
...wwww.1w.
.w.w2...w.w
......1..+w
...........
.........w.
