A......w..w
.+.w..3..2.
........w.w
...w....3.w
.w...1w...w
...ww1.w13g
ww..w......
