..w....w.w.
....+....A.
.......w...
3.2.3......
......w.ww.
.3.3ww.3w..
.w......gw.
