.2.......ww
w...w...ww.
..w..w.+ww2
..w.w.gw.w.
w.ww.....w.
...........
.....ww..A.
