.w.w......w
...w.......
w..w...w..w
+..w..w.w.A
g.......w..
ww..w......
...w..1....
