3.....w.ww.
.w.w.w..ww.
.+.w......A
ww.www.....
....w......
..w2...w..w
....w.....g
