ww.w..w.A..
....w.w....
........ww.
.w.w..+..w.
.ww......1.
.....ww....
.gw...ww.ww
