..w........
..1w.ww....
w3ww+www...
w.g.2ww....
....w.w....
33w...w....
.www.....A.
