.ww.A...w2+
..1.ww....w
.3.ww...ww.
..w.....w..
...ww...g..
...2w......
w1w.1.3w..w
