...w..ww...
w.wwg.....w
....1w..w..
.....w...w+
...311...w.
.1..ww.A..1
3.3..w.www.
