...+.w.w...
.2...1..w1.
.....w.....
32...w..w.w
..w3.2.w...
.w.ww....w.
...Aw....g.
