w3....+3ww.
.....w.ww..
..123......
..2.w..wwww
....w.www..
A.....w.w1g
..w..2.....
