w..2.w....w
...w3..1wg.
....ww.....
.www..w.w.w
3.w.......w
.+.ww...Aw.
.....2w....
