..w.ww.....
..3....2w.w
........gAw
...+.......
........ww.
.w...2ww.w.
.....w.....
