.w..w..+.ww
..1........
.ww1....w..
.w.......ww
.....www...
..w.....w..
3w..wg..A.w
