.2.....gw.w
.w.w.......
.Aw.w......
..........+
....w.....w
w..w..w3...
ww..w..ww..
