.w...w..wg2
..w.3..3w..
..1.ww2.ww.
..3..w...3.
..w.ww....w
......www..
.w+w.wA....
