..w...2...w
......1.3..
.w.Awwgw...
.w...w.....
..w....w...
+..w..w.w.w
..2.w.w1...
