A.w.3ww..w.
..w.....w..
..w..ww...w
....gw3.w+.
.wwww..2.w.
.w.w.2.....
........ww.
