1.+2w....w.
..w......w.
w..www.gw..
.w...w.....
...A...w.w.
w..ww..2...
...w.....w.
