......33..A
2..w...w.g.
..wwww.ww..
+..2..ww...
..w...w...w
..w..w.....
..w..w.w.w.
