....www....
.w...w..g..
.3.w..w....
..+.....wA.
.w..w......
..wwww....w
.w..2...w..
