.ww.....ww.
...w.ww....
..ww.......
..ww.w.....
..w.w..w+w.
A...w....g.
.ww....2..w
