.w......w..
..w.w....3.
w...A....w.
.......2..w
.w..w..g..3
www.w...w..
....+w..w..
