.w.1....w..
.....13...w
..g.......A
....w.w....
w2w.w..2.+.
3.ww...w..w
..w...w....
