1.w...g....
.32...w....
w3.......w.
.3w...wAw.w
.w.ww..w.+.
1.........w
.w..w..ww..
