..g...w....
..3w....www
...ww3w...+
w....w1.w..
w......w...
1w..A.w...w
.3..wwwww..
