.w.......w.
..www...ww.
..w..w.w2..
.+........g
3..w...w...
.ww.w..w...
.........A.
