...w..w....
.w.....3..w
..3w.w.1.w.
...ww..w.w.
2+.w1..g..A
..ww...w...
.......w..w
