...........
ww.wwww...2
w....w.....
.www2.w....
...+w.Aw...
.g..wwww...
..w.3......
