....1wA.w.1
..+www.....
..ww2..wg.3
w31.w.w..w.
.1w...2w..w
..w.....1..
.....w.....
