ww..w.....A
w.......1..
...w...w...
....w..3...
w.w.....w..
w+...ww..g.
...w....w..
