.........ww
.wwwww....w
.....w...w.
w1w..ww.A..
...2.w.....
w+.ww...g..
......ww...
