....w....w.
..w.w+.w...
.....w...w.
.w..ww..w..
.ww......w.
w..Awwgw.w.
...w...3..w
