ww.....w..w
.+.3....Aww
...w..g....
w.www......
....2.3....
...3w..2w..
....w.w...w
