.....wA.ww.
3.wg.w.w...
w.......w.w
.www.2w....
..+.w.w...w
..ww..w....
...........
