......w.+ww
..wAw.w....
..www.ww...
...........
.ww.ww...g.
.1ww1w13..w
...........
