Aw..2.g....
....ww.w.w.
....ww.....
w.........w
ww.ww+ww...
..w.....2..
.....1.www.
