w...w2.ww.w
......w..2.
A..w...www.
...w.ww.w+.
w..w.......
w......g...
ww.w.3..2..
