w...A.www..
......w31.w
.......w.gw
.w.......ww
w..w.w...w.
..ww...w..3
..3....+w.w
