3...w......
.+.ww..ww..
2w.ww..w...
..ww.A....g
..w..w.....
w..........
w..........
