w.......A..
.+...3...gw
.w..w.w..ww
...w..ww...
.ww.......w
.2w.w...2.w
..w1.w.....
