www..2.ww..
.w...www..w
..w..3w....
.Aw..2...w.
.w...3w...w
...........
w..w.+.w.wg
