ww...w3....
...w..w...w
w.w..3.ww.w
w..w...w...
.A..w......
.......w1.+
w.....wg...
