3wwwgw.....
..w...w....
.A...w..w..
.w.www.....
.w.ww....+.
.1w........
..3..w.w...
