...........
...ww.w....
.w.w.......
...w.w.w...
.w..2..wwA.
g...3w+....
..w.www....
