.2.w..A.ww.
w..........
ww...ww..w.
w.......ww.
.1.g.1..w.w
+.2.ww..w.w
.w..w......
