w........w.
....w..w3..
1www...ww..
.....w..3w.
w...ww.....
.....w..w..
w.+..1wA.g.
