23ww+...wwg
w.w2.2w....
..w........
3..........
...w.w....w
.....w..w..
.....w.Aw..
