ww.2.....w+
www........
.2...w..w..
w..g.w.ww..
.......3.w.
.....Aw.ww.
.ww..w.....
