1wwww3w....
...w.+w...w
..w.....w..
w.w...1....
..........w
....A.w.w..
.......g..w
