...........
+...w..w...
w....w.ww..
w....3wA..w
.ww..w..w..
...........
.....wwg...
