......wA...
.w2w...ww..
ww....w1...
...3www.w..
.....w..wg.
w+.....w...
..w...ww.w.
