w.g..w.w..A
.+.........
w...ww..w..
....w3.w...
.w..ww..w.w
.w........w
.....w.....
