w.........w
w....ww....
.w...g..A.w
..w...w..w.
w......www.
w..w....w..
1.w.2ww...+
