.w...1.....
...ww..g.w.
+.....w1...
w....ww.ww.
..w.w.....2
w...ww..Aw.
........w..
