+..w1..22..
..wwwwww.w.
...ww......
..w....w..w
w.w...g....
...w...A...
w.....w.w..
