......ww..w
1.3w.....w.
ww+w.www...
w.....A....
..ww.w....g
.w......w..
w..w.......
