...A.....+.
wwww..w....
w..w..w.ww.
...w...ww..
.w.3..w.ww.
...g....w..
.w.........
