.......w...
....w.w....
2w...ww3.3w
..w..w...w+
...g.w..w..
1..A.......
..w.w....w.
