.w..w..23.3
..w....w..g
A.ww....w..
.w.1ww.1w.w
..w2.+w...1
.2.w....3..
.w....w...2
