..ww2..w...
w.ww......w
..1.....g..
w...w......
..3w.w.ww..
1www+Aww...
..w........
