...ww......
w.ww..wgw..
...ww.w...2
+w...w.w...
..w........
w...w....ww
..w..w.w..A
