w..w.ww....
......gw...
..w...w.w..
...w..wA.w.
...........
.2www..w.w.
...3w...ww+
