..Aw.....w.
...ww1..ww.
.+w.w..w...
....1..1.g.
....w.w....
2....3.ww..
...w.wwww3w
