w.......w..
.ww....A..w
.w.........
...w.w.ww.2
+ww........
.ww..w.w.g2
.......ww..
