.3.w....w..
.w...w.w...
.3.ww..g...
w.2..wA....
.......w...
+www.w.w.w.
.2..w.....w
