...........
w........w.
.w..w.....w
..w......w.
....w....A.
3gw........
...2.w....+
