+w.ww..w...
.....w...A.
.2....w...w
.w......www
..1w.....w.
ww3..w.g...
....w......
