..w.ww...gw
..w..ww..1.
...w.w.....
w....w....w
A.w...w...w
..2.1......
ww......ww+
