.....w.....
g.....w1..w
w....w3.w+.
..www......
.ww.w..ww..
.......w...
w.wwA.ww...
