.w...w.....
...w.w.....
..w......w.
....w......
....gw..w..
.w.A.......
2.......w.+
