...........
ww2.ww.....
...ww1wwwg.
.ww....w..+
.w..www...w
.....Aw....
.3.....w...
