w...2.w.g..
.....ww....
w..w...Aw.w
..w.......w
w.w......ww
...ww...ww.
w+...w.....
