21w....w.w.
g..w.......
.2....w..w.
.ww....ww..
..ww.1.ww+.
w.w..w.w...
..w.wA.....
