g...ww.w...
..w........
.....ww1..w
..wA.w.....
...wwww...w
w..w...w..w
.1....w.+..
