....A..w.w.
w..ww..w...
..ww......w
w..w.www...
w1.w....w.w
.w...w...+.
....g......
