....w.w....
....w.ww+..
ww.....ww..
2....w.....
..www...2..
w.........A
..w...1w..g
