w..www..+..
.w...gw.11w
..3w.ww....
......w...w
.w.ww.wA...
.w...1.w..3
ww........w
