.....1.3...
wgw..3.....
.....3+..ww
..w.w1.w...
....w...w..
w.3w..ww...
w.w.2..A...
