w....w.....
..ww...w...
..w2..2.w..
..Aw.ww.w.w
..g...w2w.w
.3..w...w.+
......w...w
